"filename", "language", "HTML", "Java", "XML", "YAML", "comment", "blank", "total"
"e:\codes\idea_workspace\demo\src\main\java\cn\edu\seu\demo\DemoApplication.java", "Java", 0, 12, 0, 0, 0, 5, 17
"e:\codes\idea_workspace\demo\src\main\java\cn\edu\seu\demo\config\WebConfig.java", "Java", 0, 14, 0, 0, 1, 3, 18
"e:\codes\idea_workspace\demo\src\main\java\cn\edu\seu\demo\controller\AdminController\AdminLoginController.java", "Java", 0, 48, 0, 0, 9, 10, 67
"e:\codes\idea_workspace\demo\src\main\java\cn\edu\seu\demo\controller\UserController\LoginController.java", "Java", 0, 52, 0, 0, 9, 10, 71
"e:\codes\idea_workspace\demo\src\main\java\cn\edu\seu\demo\controller\UserController\UserNewsRecommendController.java", "Java", 0, 75, 0, 0, 26, 11, 112
"e:\codes\idea_workspace\demo\src\main\java\cn\edu\seu\demo\controller\UserController\UserNewsSummarizeController.java", "Java", 0, 48, 0, 0, 16, 9, 73
"e:\codes\idea_workspace\demo\src\main\java\cn\edu\seu\demo\intercepter\LoginCheckInterceptor.java", "Java", 0, 40, 0, 0, 9, 5, 54
"e:\codes\idea_workspace\demo\src\main\java\cn\edu\seu\demo\mapper\AdminMapper\AdminLoginMapper.java", "Java", 0, 9, 0, 0, 0, 3, 12
"e:\codes\idea_workspace\demo\src\main\java\cn\edu\seu\demo\mapper\UserMapper\LoginMapper.java", "Java", 0, 9, 0, 0, 0, 3, 12
"e:\codes\idea_workspace\demo\src\main\java\cn\edu\seu\demo\mapper\UserMapper\UserNewsRecommendMapper.java", "Java", 0, 26, 0, 0, 43, 16, 85
"e:\codes\idea_workspace\demo\src\main\java\cn\edu\seu\demo\mapper\UserMapper\UserNewsSummarizeMapper.java", "Java", 0, 17, 0, 0, 0, 7, 24
"e:\codes\idea_workspace\demo\src\main\java\cn\edu\seu\demo\pojo\Admin.java", "Java", 0, 12, 0, 0, 0, 3, 15
"e:\codes\idea_workspace\demo\src\main\java\cn\edu\seu\demo\pojo\Classify.java", "Java", 0, 12, 0, 0, 0, 4, 16
"e:\codes\idea_workspace\demo\src\main\java\cn\edu\seu\demo\pojo\HistoryText.java", "Java", 0, 15, 0, 0, 0, 4, 19
"e:\codes\idea_workspace\demo\src\main\java\cn\edu\seu\demo\pojo\News.java", "Java", 0, 11, 0, 0, 0, 4, 15
"e:\codes\idea_workspace\demo\src\main\java\cn\edu\seu\demo\pojo\NoContentNews.java", "Java", 0, 19, 0, 0, 0, 4, 23
"e:\codes\idea_workspace\demo\src\main\java\cn\edu\seu\demo\pojo\PageBean.java", "Java", 0, 12, 0, 0, 1, 5, 18
"e:\codes\idea_workspace\demo\src\main\java\cn\edu\seu\demo\pojo\Result.java", "Java", 0, 21, 0, 0, 3, 4, 28
"e:\codes\idea_workspace\demo\src\main\java\cn\edu\seu\demo\pojo\Source.java", "Java", 0, 11, 0, 0, 0, 3, 14
"e:\codes\idea_workspace\demo\src\main\java\cn\edu\seu\demo\pojo\User.java", "Java", 0, 13, 0, 0, 0, 3, 16
"e:\codes\idea_workspace\demo\src\main\java\cn\edu\seu\demo\service\AdminService\Impl\AdminLoginServiceImpl.java", "Java", 0, 15, 0, 0, 0, 4, 19
"e:\codes\idea_workspace\demo\src\main\java\cn\edu\seu\demo\service\AdminService\LoginService.java", "Java", 0, 5, 0, 0, 0, 4, 9
"e:\codes\idea_workspace\demo\src\main\java\cn\edu\seu\demo\service\UserService\LoginService.java", "Java", 0, 5, 0, 0, 0, 4, 9
"e:\codes\idea_workspace\demo\src\main\java\cn\edu\seu\demo\service\UserService\UserNewsRecommendService.java", "Java", 0, 14, 0, 0, 0, 10, 24
"e:\codes\idea_workspace\demo\src\main\java\cn\edu\seu\demo\service\UserService\UserNewsSummarizeService.java", "Java", 0, 11, 0, 0, 0, 7, 18
"e:\codes\idea_workspace\demo\src\main\java\cn\edu\seu\demo\service\UserService\impl\LoginServiceImpl.java", "Java", 0, 15, 0, 0, 0, 3, 18
"e:\codes\idea_workspace\demo\src\main\java\cn\edu\seu\demo\service\UserService\impl\UserNewsRecommendServiceImpl.java", "Java", 0, 62, 0, 0, 45, 13, 120
"e:\codes\idea_workspace\demo\src\main\java\cn\edu\seu\demo\service\UserService\impl\UserNewsSummarizeServiceImpl.java", "Java", 0, 43, 0, 0, 6, 8, 57
"e:\codes\idea_workspace\demo\src\main\java\cn\edu\seu\demo\utils\ChatClient.java", "Java", 0, 37, 0, 0, 6, 12, 55
"e:\codes\idea_workspace\demo\src\main\java\cn\edu\seu\demo\utils\JwtUtils.java", "Java", 0, 23, 0, 0, 22, 11, 56
"e:\codes\idea_workspace\demo\src\main\java\cn\edu\seu\demo\utils\Model_eval.java", "Java", 0, 6, 0, 0, 30, 4, 40
"e:\codes\idea_workspace\demo\src\main\resources\application.yml", "YAML", 0, 0, 0, 16, 19, 4, 39
"e:\codes\idea_workspace\demo\src\main\resources\cn\edu\seu\demo\mapper\usermapper\UserNewsRecommendMapper.xml", "XML", 0, 0, 25, 0, 1, 2, 28
"e:\codes\idea_workspace\demo\src\main\resources\static\index.html", "HTML", 6, 0, 0, 0, 0, 0, 6
"e:\codes\idea_workspace\demo\src\test\java\cn\edu\seu\demo\DemoApplicationTests.java", "Java", 0, 35, 0, 0, 15, 11, 61
"Total", "-", 6, 747, 25, 16, 261, 213, 1268